00000000000000
01110100011100
01010100010000
01010100010000
01110100010100
01000100010100
01000100010100
01000111011100
00000000000000