11111144111111
22222444422222
33334444443333
22222444422222
11111144111111